0000000000000000000000000000000000000000000000000000000000000000000000000000000000000000000000000000
0000000000000000000000000000000000000000000000000000000000000000000000000000000000000000000000000000
0000000000000000000000000000000000000000000000000000000000000000000000000000000000000000000000000000
0000000000000000000000000000000000000000000000000000000000000000000000000000000000000000000000000000
0000000000000000000000000000000000000000000000000000000000000000000000000000000000000000000000000000
0000000000000000000000000000000000000000000000000000000000000000000000000000000000000000000000000000
0000000000000000000000000000000000000000000000000000000000000000000000000000000000000000000000000000
0000000000000000000000000000000000000000000000000000000000000000000000000000000000000000000000000000
0000000000000000000000000000000000000000000000000000000000000000000000000000000000000000000000000000
0000000000000000000000000000000000000000000000000000000000000000000000000000000000000000000000000000
0000000000000000000000000000000000000000000000000000000000000000000000000000000000000000000000000000
0000000000000000000000000000000000000000000000000000000000000000000000000000000000000000000000000000
0000000000000000000000000000000000000000000000000000000000000000000000000000000000000000000000000000
0000000000000000000000000000000000000000000000000000000000000000000000000000000000000000000000000000
0000000000000000000000000000000000000000000000000000000000000000000000000000000000000000000000000000
1000001111111111111110000000000011111111111111111111111111111111111111111111111111111111111111111111
1000011111111111111110000000000001111111111111111111111111111111111111111111111111111111111111111111
1000011111111111111111000000000000111111111111111111111111111111111111111111111111111111111111111111
1000011111111111111110000000000000111111111111111111111111111111111111111111111111111111111111111111
1000011111111111111110000000000000111111111011111111111111111111111111111111111111101111111111111111
1100001111111111111110000000000000111111110001111111111111111111111111111111111111000111111111111111
1100011111111111111110000000000000011111100001111111011111111001111111110111111110000111111111111111
1100001111111111111111000000000000001111100001111110011111111000011111100111111110000111111000111111
1100000111111111111110000000000000000011000000111100000001110000000111000000011100000000100000000111
1000000001101111111110000000000000000000000000000000000000110000000000000000001100000000000000000011
1100000001101111111111000000000000000000000000000000000000000000000000000000000000000000000000000000
1000000001001111111110000000000000000000000000000000000000000000000000000000000000000000000000000000
1000000001111111111110000000000000000000000000000000000000000000000000000000000000000000000000000000
1100000001111111111111000000000000000000000000000000000000000000000000000000000000000000000000000100
1000000001111111111110000000000000000000000000000000000000000000000000000000000000000000000000111100
1000000011111111111110001000000000000000000000000000000000110000000000000000001100000000000001111111
1000000111111111111110001000010000110111000000000000001101110000000000000011011100000000000011111111
1000000111111111111111000000010000111111100000000000001111110000000000000011111000000000011111111111
1000000111111111111111000001110001111111110000000100011111110000000001000111111100000000011111111111
1000000111111111111111000001111011111111100000001110111111111000000011101111111110000000111111111111
1000000111111111111111000001111111111111100000011111111111111000000111111111111110000000111111111111
1000000011111111111111000001111111111111100000011111111111111000000111111111111110000000111111111111
1000000001111111111111000011111111111111100000011111111111111100001111111111111110000000011111111111
1000000001111111111111000011111111111111100000011111111111111100001111111111111110000000011111111111
1100000000111111111111100011111111111111100000000111111111111110001111111111111110000000001111111111
1100000000111111111111000011111111111111110000001111111111111100001111111111111110000000001111111111
1110000001111111111111100111111111111111110011111111111111111110011111111111111111000000011111111111
1110000001111111111111100111111111111111110001111111111111111110011111111111111110000000011111111111
1110000001111111111111100111111111111111100000011111111111111110011111111111111111000000011111111111
1110000001111111111111100011111111111111110000011111111111111110011111111111111110000000011111111111
1110000001111111111110000001111111111111110000011111111111111100001111111111111111000000011111111111
1000000000001111111100000001111111111111110010011111111111111000000111111111111110000000011111111111
1000000000000011111100000000111111111111110010011111111111111000000111111111111110001000011111111111
1000000000000001111000000000111111111111100010011111111111111000000111111111111111111001111111111111
1000000000000000011100000001111111111111100010011111111111111000000111111111111111111001111111111111
1000000000000000010000000001111111111111100000011111111111111000001111111111111111111001111111111111
1000000000000000000000000001111111111111110000011111111111111100000111111111111111111001111111111111
1100000000000000000000000001111111111111110000011111111111111100000111111111111111100001111111111111
1100000000000000000000000001111111111111110000011111111111111000000111111111111111100001111111111111
1000000000000000000000000011111111111111100000011111111111111000001111111111111110100001111111111111
1000000000000000000000000011111111111111100000111111111111111000001111111111111110000011111111111111
1000000000000000011000000111111111111111110011111111111111111100000111111111111100001111111111111111
1100000000000000011110001111111111111111110011111111111111111100001111111111111100001111111111111111
1000000100000000011110001111111111111111100001111111111111111000000111111111111100001111111111111111
1000000010000000111110111111111111111111100000111111111111111000000111111111111110000111111111111111
2000002220000002222222222222222222222222200000222222222222222200002222222222222222000222222222222222
2000002222000222222222222222222222222222200002222222222222222200022222222222222222002222222222222222
2000002222000222222222222222222222222222200002222222222222222200022222222222222222222222222222222222
2000000000000222222222222222222222222222200000222222222222222000000222222222222222222222222222222222
2000000000000222222222222222222222222222220000022222222222222200000222222222222222222222222222222222
2000000002002222222222222222222222222222220000022222222222222000000222222222222222222222222222222222
2200000002000222222222222222222222222222220000222222222222222200002222222222222222222222222222222222
2200000002000222222222222222222222222222220000222222222222222200002222222222222222222222222222222222
2000000000000222222222222222222222222222222000022222222222222000000222222222222222222222222222222222
2000000000000222222222222222222222222222222220022222222222222000000222222222222222222222222222222222
2200000000000022222222222222222222222222222220022222222222222200000222222222222222222222222222222222
2200000000000022222222222222222222222222222220022222222222222200200222222222222222022222222222222222
2000000000000002222222222222222222222222222220022222222222222000000222222222222220002222222222222222
2000000000000000222222222222222222222222222220022222222222222220000222222222222222002222222222222222
2000000000000000022222222222222222222222222220022222222222222220200222222222222220000022222222222222
2000000000000000022222222222222222222222222220022222222222222222200222222222222220000022222222222222
0000000000000000000222222222222222222222222220002222222222222222200022222222222220000002222222222222
2000000000000000000222222222222222222222222220000222222222222222000002222222222222000002222222222222
2220000000000000000022222222222222222222222220000022222222222220000000222222222222000002222220000222
2220000000000000000022222222222222222222222220000022222222222222000000222222222222000000222220000222
2222000000000000000222222222222222222222222220000222222222222222000002222222222222000022222222222222
2222220000000000002222222222222222222222222222002222222222222222222222222222222222002222222222222222
2222220000000000002222222222222222222222222222002222222222222222222222222222222222000222222222222222
2222220000000000002222222222222222222222222222002222222222222222222222222222222222200002222222222222
2222220000000000002222222222222222222222222222022222222222222222222222222222222222000002222222222222
2222220000000000002222222222222222222222222222222222222222222222222222222222222222000002222222222222
2222220000000000002222222222222222222222222222222222222222222222222222222222222222000002222222222222
2222220000000000022222222222222222222222222222222222222222222222222222222222222222002002222222222222
2222220000000000022222222222222222222222222222222222222222222222222222222222222222222002222222222222
2222220000000000022222222222222222222222222222222222222222222222220222222222222222222002222222222222
2222220000000000022222222222222222222222222220022222222222222222200222222222222222222002222222222222
2000220200000000022222222222222222222222200000002222222222222000000022222222222222222002222222222222
2000022222000000022220022222222222222222200000000222222222222000000002222222222222200022222222222222
2000002222200022022200000002222222222222200000002220222222222000000002202222222222200022222222222222
0000002222202222222200000000222222222222000000022200222222220000000002002222222222000022222222222222
2000002222222222222220000000222222222222200000022220222222222000000002202222222222000022222222222222
2000002222222222222220000000222222222222200000022222222222222000000002222222222220000022222222222222
2000002222222222222222000002222222222222200000222222222222222200000222222222222220000022222222222222
2000002222222222222220000002222222222222200000222222222222222000000222222222222220000022222222222222
2200002222222222222220000002222222222222220000222222222222222000000222222222222222000022222222222222
