0000000000000000000000000000000000000000000000000000000000000000000000000000000000000000000000000000
0000000000000000000000000000000000000000000000000000000000000000000000000000000000000000000000000000
0000000000000000000000000000000000000000000000000000000000000000000000000000000000000000000000000000
0000000000000000000000000000000000000000000000000000000000000000000000000000000000000000000000000000
0000000000000000000000000000000000000000000000000000000000000000000000000000000000000000000000000000
0000000000000000000000000000000000000000000000000000000000000000000000000000000000000000000000000000
0000000000000000000000000000000000000000000000000000000000000000000000000000000000000000000000000000
0000000000000000000000000000000000000000000000000000000000000000000000000000000000000000000000000000
0000000000000000000000000000000000000000000000000000000000000000000000000000000000000000000000000000
0000000000000000000000000000000000000000000000000000000000000000000000000000000000000000000000000000
0000000000000000000000000000000000000000000000000000000000000000000000000000000000000000000000000000
0000000000000000000000000000000000000000000000000000000000000000000000000000000000000000000000000000
0000000000000000000000000000000000000000000000000000000000000000000000000000000000000000000000000000
0000000000000000000000000000000000000000000000000000000000000000000000000000000000000000000000000000
0000000000000000000000000000000000000000000000000000000000000000000000000000000000000000000000000000
1111111111111110000000111111111111110000000000000111110111000000000000000000001111111111111111111111
1111111111111110000000011111111111110000000000001111111111100101000000000000001111111111111111111111
1111111111111100000000011111111111110000000000001111111111101111000000000000001111111111111111111111
1111111111111100000001111111111111111000000000001111111111111111000000000000001111111111111111111111
1111111111111110000011111111111111111111111000011111111111111111100000000000001111111111111111111111
1111111011111111100111111111111111111111111100011111111111111111100000000000001111111111111111111111
1111111011111111111111111111111111111111111111111111111111111111100000000000000111111111111111111011
1111111011111111111111111111111111111111111111111111111111111111110000000000000001111111111111110000
0111110011111111111111111111111111111111111111111111111111111111111000000000000000011111111111111000
0011111001111111111111111111111111111111111111111111111111111111111000000000000000011111111111110000
0011110000111111111111111111111111111111111111111111111111111111111000000000000000000111111111110000
0111111100011011111111111111111111111111111111111111111111111111111110000000000000000001011111100000
0011111001001111111111111111111111111111111111111111111111111111111111000000000000000000000010000000
0111111111111101111111111111111111111111111111111111111111111111111110000000000000000000000000000001
1111111111111111111111111111111111111111111111111111111111111111111111000000000000000000000000000011
1111111111111111111111111111111111111111111111111111111111111111111111100000000000000000000000000011
1111111111111111111111111111111111111111100011111111111111111111111111100000000000000000000000000011
1111111111111111111111111111111111111111000001111111111111111111111111100000000000000000000000000111
1111111111111110001111111111111111011111000000011111111111111111111111100000000000000000000000000111
1111111111111110000111111111111110000011000000000111111111111111111111110000000001000000000000000000
1111111111111110000111111111111110000111000110000111111111111111111111111000000000000000000000000000
1111111111110000001111111111111100000111101111101111111111111111111111111001100000000000000000000001
1111111110000000001111111111111000000111111111101111111111111111111111111101100001001000000000000011
1111111110000000000111111111111110000011111111100111111111111111111111111110111001111000000000001111
1111111111000000000111111111111111000111111111010011111111111111111111111111111111111100000000001111
1111111110000000001111111111111111101111111111110111111111111111111111111111111111111100000000001111
1111111110000000001111111111111111111111111111111111111111111111111111111111111111111100000000000111
1111111100000000001111111111111111111111111111111111111111100000011111111111111111111100000000000111
1111111000000000001111111111111111111111111111001111111111100000011111111111111111111100000000000111
1111111000000000000111111111111111111111111100000111111111110000011111111111111111111111000000000111
1111111000000000000011111111111111111111111111000111111111110000111111111111111111111111000000000000
0011111100000000000111111111111111111111111111111111111111111110111111111111111111111111000000000000
0011111100000000001111111111111111111111111111111011111111111010111111111111111111111111100000000000
0011111110000000000011111110011111111111111111111111111111111001111111111111111111111111110000000000
0011111110000000000001110000011111111111111111111111111111111000111111111111111111111111111110000000
0011111110000000000001100000011111111111111111111111111111111111111111111111111111111111111111110000
0111111110000000000000000000011111111111111111111111111111111111111111111111111111111111111111111111
0111111111000000000000000000001111111111111111111111111111111111111111111111111111111111111111111111
0111111111000000000000000000001111111111111111111111111111111111111111111111111111111111111111111111
0011111111100000000000000000001111111111111111111111111111111111111111111111111111111111111111111111
0111111111110000000000000000000000011111111111111111111111111111111111111111111111111111111111111111
1111111111111100000100000000000000000111111111111111111111111111111111111111111111111111111111111111
1111111111111100001111011000000000000000111111111111111111111111111111111111111111111111111111111111
1111111111111000001111111100000000000000111111111111111111111111111111111111111111111111111111111111
1111111111111100000111111110000000000000111111111111111111111111111111111111111111111011111111111111
2222222222222200022222222222000000000000222222222222222222222222222222222222222222200002222222222222
2222222222222202222222222222200000000002222222222222222222222220222222222222222222000000222222222222
2222222222222222222222222222222020000002222222222222222222222222222222222222222222000000222222222220
2222222222222222222222222222222000000002222222222022200022222220002222222222222200000000002222222200
2222222222222222222222222222222000000000222222222000000022200220000000222222222200000000000222220000
2222222222222222222222222222220000000000222222222000000022000020000000000222222200000000000000000000
2222222222222222222222222222220000000000222222222000000000000000000000020222222220000000000000000000
2222222222222222222222222222220000000000222222222000000000000000000000002222222220000000000000000000
0222222222222222222222222222220000000000222222222200000000000000000000000222222222000000000000000000
0022222222222222222222222222220000000000222222222220000000000000000000000222222222000222220000000000
0002222222222222222222222222220000000002222222222222200000000000000000000222222222222222222000000000
0002002222222222222222222222220000000022222222222222220000000000000000000022222222222222222200000000
0000000222222222222222222222200000000222222222222222222000000000000000000022222222222222222222000000
0200000222222222222222222222000000022222222222222222222000000000000000000022222222222222222220000022
0000000222222222222222220220000000002222222222222222222000000000000000000222222222222222222220000202
0000002222222222222222200000000000002222222222222222222000000000000000000022222222222222222220000000
0200222222222222222222220000000000002222222222222222222220000000000000000002222222222222222222000000
0222222222222222222222220000000000002222202222222222222222200000000000000002222222222222220000000000
2222222222222222222222200000000000002222200222222222222222222222200000000002222222222222222000000000
2222222222222222222222000000000000002222220022222222222222222222020000000002222222222222222000000002
2222222222222222222222220000000000022222222222222222222222222222000000000000222222222222222202000002
2222222222222222222222202000000000222222222222222222222222222222200000000000000222222222222220000002
2222222222222222222222222000000000222222222222222222222222222222220000000000000022222222222220000002
2222222222222222222222220000000000222222222222222222222222222222200000000000000002222222222200000002
2222222222222222220222220000000022222222222222222222222222222222200000000000000002222220222000000222
2222222222222222220022220000000020222222222222222222222222222222200000000000000002220000000000000222
2222222222222222200002220000000000222222222222222222222222222222000000000000000002200000000000000022
2222222222222222200002220000000022222222222222222222222222222220000000000000000000020000000000000022
2222222222222222222022220000000022222022222222222222222222222220000000000000000000000000000000000000
2222222222222222222222200000000022220022222222222222222220222222000000000000000000000000000000000000
2222222222222222222222220000000022222222222222222222222220022222000000000000000000000000000000000000
2222222222222222222222222000000222222222222222222222222000222222222220222200000000000000000000000000
2222222222222222222222222000000222222222222222222222220000222222222222222220000000000000000000000000
2222222222222222222222222000000022222222222222222222020000222222222222222222000000000000000000000000
2222222222222222222222222000000002222222222222222220000000222222222222222222000000000000000000000000
2222222222222222222222222200000000022222222222222200000000222222222222222222200000000000000000000000
0222222222222222222222222220000000002222222222222220000000022222222222222222220000000000000000000000
0022222222222222222222222222000000000022222222222220000000022222222222222222222200000000000000000000
0022222222222222222222222222200000000002222222222000000000002222222222222222222222200000000000000000
2222222222222222222222222222200000000002222222220000000000002222222222222222222222220000000000022222
