00000000000000000000000000000000000000000000000000000000000000000000000000000000
00000000000000000000000000000000000000000000000000000000000000000000000000000000
00000000000000000000000000000000000000000000000000000000000000000000000000000000
00000000000000000000000000000000000000000000000000000000000000000000000000000000
00000000000000000000000000000000000000000000000000000000000000000000000000000000
00000000000000000000000000000000000000000000000000000000000000000000000000000000
00000000000000000000000000000000000000000000000000000000000000000000000000000000
00000000000000000000000000000000000000000000000006666660660500000000000000000000
00000000000000000000000000000000000000000000006660000000000056606000000000000000
00000000000000000000000000000000000000000006600000000000000000000066600000000000
00000000000000000000000000000000000000066660000000000000000000000000066600000000
00000000000000000000000000000000000066600000000000000000000000000000000660000000
00000000000000000000000000000000003600000000000000000000000000000000000060000000
00000000000000000000000000000000000666600000000000000000000000000000000660000000
00000000000000000000000000000000000000066660000000000000000000000000066600000000
00000000000000000000000000000000000000002222262220000000000000000666600000000000
44466666700000000000000000032000000000000000066600222022222222536000000000000000
00000000777777000000000000032200000000000000000056000000000000000000000000000000
00000000000000766666000000300200000000000000000006600000000000000000000000000000
00000000000020000006666660300020000000000000000001612222333000000000550000000000
00000000023022000000000066366623333222222333334544464444444555340000550000000000
00000000023022000003333333330062333333333344445500060000070005550005050000000000
00000000002002333220000003000002000000000000005500066000550000000005070000000000
00000000002032200220000003000000200000000000005000006000500000000005070000000000
00000000002322255200000030000000200000000000050500060000500000000005050000000000
00000000002302200255555535000000200000555000000600006005050000000000050000000000
00000000002000020200000035544440200005505000050555554005050000000050005000000000
00000000002302020240000030000044424005005000555606005505000000000057005000000000
00000000002032002240000300000000020355305055500666605050050000000007000000000000
44000000002232003240000300000000020050355550003660605000050000000507005000000000
00440000022003003240000301500000050500055033336720665505000000000507005000000000
00005500020202000240003001504444050525333335363345065005050000000005700000000000
00000055622203040240003005220104555555522000030535565505050000005005700500000000
00000000662603040240003015044444005545000205030530005556000000005005700500000000
00000000000262346640033015440110005554444444330230055556405000000050700000000000
00000000002002000162636614001100044002440024444530057500440000050050700500000000
00000000020200401042030124441000040002004453304333056700045000050070700500000000
00000000002202032042220121146000040012000432233353556700004000500700000500000000
00000000002000431040220112006600044222222542002530650400005000000700070000000000
00000000020204032040001002211661111442003440002535650440004505500700070500000000
00000000022200231242221222222266000004444422226565350040004507000700070500000000
00000000222224213040001000022226622220005006666553350040044550004000075000000000
00000000422204013040010000000222666622466666000553050004440050004000070000000000
00000000020242433240010000000000224664454400000004454444000000000000075000000000
00000000022202333033133333333334444444444442222222350004000000004000075000000000
00000000002240300001100000000000000000000000000000300000400000040000075000000000
70770700727400300000000000000000000000500000000002200000400000040000007500000000
77700700740477570077070007700007000022000000000220000000400000000000007500000000
00000000044477707070070007700707000112222222222200000000440000040000007500000000
00000000044000000000000000000077070005300000000007007707077000400000007500000000
00000000004000000000000077770707700777667000007000000000044000400000007500000000
00000000000000000000000000000000000766667007707077700770704000400000000000000000
00000000000000000000000000000005050507077070070777000000004404400000000000000000
00000000000550050050500505050500005500000000000000000000000444000000000000000000
00000005555505050000050050050005005000000000000000000000000044000000000000000000
00000000000000000000000000000000005555555575550000000000000000000000000000000000
00000000000000000000000000000000000000000000000000000000000000000000000000000000
00000000000000000000000000000000000000000000000000000000000000000000000000000000
00000000000000000000000000000000000000000000000000000000000000000000000000000000
00000000000000000000000000000000000000000000000000000000000000000000000000000000
