0000000000000000000000000000000000000000000000000000000000000000000000000000000000000000000000000000
0000000000000000000000000000000000000000000000000000000000000000000000000000000000000000000000000000
0000000000000000000000000000000000000000000000000000000000000000000000000000000000000000000000000000
0000000000000000000000000000000000000000000000000000000000000000000000000000000000000000000000000000
0000000000000000000000000000000000000000000000000000000000000000000000000000000000000000000000000000
0000000000000000000000000000000000000000000000000000000000000000000000000000000000000000000000000000
0000000000000000000000000000000000000000000000000000000000000000000000000000000000000000000000000000
0000000000000000000000000000000000000000000000000000000000000000000000000000000000000000000000000000
0000000000000000000000000000000000000000000000000000000000000000000000000000000000000000000000000000
0000000000000000000000000000000000000000000000000000000000000000000000000000000000000000000000000000
0000000000000000000000000000000000000000000000000000000000000000000000000000000000000000000000000000
0000000000000000000000000000000000000000000000000000000000000000000000000000000000000000000000000000
0000000000000000000000000000000000000000000000000000000000000000000000000000000000000000000000000000
0000000000000000000000000000000000000000000000000000000000000000000000000000000000000000000000000000
0000000000000000000000000000000000000000000000000000000000000000000000000000000000000000000000000000
1000000001111111111111100000011111111100000000000000000000000111111101111000000000011111111111111111
1000000001111111111111100000011111111100000000000000000000000111111111111111100111111111111111111111
1000000001111111111111100000011111111110000000000000000000000011111111111111010111111111111111111111
1100000000111111111111000000011111111111100000000000000000000111111111111111000111111111111111111111
1100000000111111111110000000111111111111110000000000000000001111111111111111001111111111111110011111
1100000000111111111110000000011111111111111110000000000000011111111111111111101111111111111110001111
1100000001111111111110000000001111111111111111100000000000011111111111111111111111111111111110001111
1100000001111111111110000000001111111111111111100000000000111111111111111111111111111111111110110111
1100000011111111111111000000011111111111111111110000000000111111111111111111111111111111111110000110
0110000011111111111110000001111111111111111111111000000001111111111111111111111111111111111110000000
1110001111111111111110000001111111111111111111111111100111111111111111111111111111111111111101100000
1110001111111111111111001111111111111111111111111111111111111111111111111111111111111111111111110000
1110001111111111111111111111111111111111111111111111111111111111111111111111111111111111111111000000
1110111111111111111111111111111111111111111111111111111111111111111111111111111111111111111111110000
1110111111111101111111111111111111111111111111111111111111111111111111111111000000111001111111111100
1101111101111101111111111111111111111111111111111111111111111111111111111111000000000000011111111100
1111010000001001111111111111111111111111111111111111111111111111111111111111000000000000001111111110
1110000000000000111111111111111111111111111111110000111111111111111111111111100000000000001111111111
1100000000000000111111111111111111111111111111100000001111111111111111111111100000000000000111111111
1100000000000000001111111111111111111111111111100000000111111111111111111111100000000000001111111111
1100000000000000001111111111111111111111111111000000000111111111111111111111100000000000111111111111
1110000000000000001111111111111111111111111110000000000011111111111111111111110111111000111111111111
0100100000000000000001111111111111111111111100000000000111111111111111111111110011111101111111111111
1011100000000000000011111111111111111111111000000000000111111111111111111111111111111111111111111111
1110000000000000000011111111111111111111110000000000000011111111111111111111111111111111111111111111
1111000000000000000111111111111111111111110000000000000001111111111111111111111111111111111111111111
1111000000000000000111111111111111111111100000000000000000001111111111111111111111111111111111111111
1111000000000000001111111111111111111111000000000000000000000000001111111111111111111111111111111111
1111000000000000011111111111111111111111000000000000000000000000001111111111111111111111111111111111
1111000000000000011111111111111111111111000000000000000000000000001111111111111111111111111111111111
1111000000000000011111111111111111111111000000000000000000000000001111111111111111111111111111111111
1100011000000000111111111111111111111111000000000000000000000000001111111111111111111111111111111111
0000111100000010011111111111111111111111000000000000000000000000011111101111111111111111111111111111
0001111100000011111111111111111100000000000000000000000000000000000110000011111111111111111111111111
0011111000011111111111111111111000000000000000000000000000000000000000000001111111111111111111111111
0001111000111111111111111111111000000000000000000000000000000000000000000001111111111111111111111111
0111111000111111111111111111110000000000000000000000000000000000000000000000111111110001111111111111
0011110000111111111111111111100000000000000000000000000000000000000000000000000111100011111111111111
1111110001111111111111111110000000000000000000000000111111000000000000000000000000000011111111111111
0111110111111111111111111110000000000000000000000011111111000000000000000000000000000111111111111111
1111111111111111111111111110000000000000000000000111111111110000000000000000000000000111111111111111
1111111111111111111111111100000000000000000000011111111111111101001100000000000000001111111111111111
1111111111111111111111111000000000000000000111111111111111111111111110000000000000001111111111111111
1111111111111111111111111000000000000000111111111111111111111111111110000011000000111111111111111111
1111001111111111111111111000000000000000111111111111111111111111111110000011001111111111111111111111
2222222222222222222222222000000000000002222222222222222222222222222000000022022222222222222222222222
2222222222222222222222222000000000002222222222222222222222222222220000000022222222222222222222220022
2222222222222222222222222000000000022222222222222222222222222222220000000002222222222222222222200000
2222222222222222222222220000000002222222222222222222222222222222220000000002222222222222222222000000
2220222222222222220222200000000002222222222222222222222222222200222200000002222222222222222222000000
2220020222222222000002222000000022222222222222222222222222222222222200000022222222222222222222000000
2220000222222222000002222220000020222222222222222222222222222222222222222222222222222222222222000000
2200000222222222000000222220000000022222222222222222222222222222222222222222222222222222222220000000
2200200222222222200002222220000000022222222222222222222222222222222222222222222222222222222200000000
2200220222222222200022222200000000022222222222222222222222222222222222222222222222222222222000000000
2222222222222222220222222222200000002222222222222222222222222222222222222222222222222222222000000000
2222222222222222222222222222200000002222222222222222222222222222222222222222222222222222220000000000
2202222222222222222222222222200000000222220222222222222222222222222222222222222222222222200000000000
0022222222222222222222222222220000000000000022222222222222222222222222222222222222222220000000000000
0022222222222222222222222222222000000000000000222222222222222222222222222222222222222000000000000002
0002222222222222222222222222220000000000000000220022222222222222222222222222222222200000000000000022
0000222222222222222222222222220000000000000000000002222222222222222222222222222222200000000000000022
2222222222222222202222222222222000000000000000000000022222222222222222222222222222200000000000000022
2222222222222000002222222222222200000002200000000000022222222222222222222222222222200000000000022222
2222222222220000022222222222222020000022222220000000002222222222222222222222222222200000000000222222
2222222222200002202222222222222222000022222222000000000222222222222222222222222222220000000022222222
2222222222220222222222222222222222000222222222200000000000000222222222222222222222222020000222222222
2222222222200022222222222222222222220222222222200000000000000022222222222222222220000020000222222222
2222222222200222222222222222222222222222222222200000000000000022222222222222222200000020022222222222
2222222222220222222222222222222222222222222222200000020000000002222222222222222000000022022222222222
2222222222222222222222222222222222222222222222200000000000000022222222222222222200000022222222220022
2222222222222222222222222220022222222222222222200000000000000022222222222222222220000022222222220002
2222222222222222222222222000000222222222222222220000000020222022222222222222222222200022222222000222
2222222222222222222222222000000222222222222200020000000002222000022222222222222222222022222000022222
2222222222222222222222222000000022222222222000020000000022200000022222222222222222222222200000002222
2222222222222222222222000000022022222222222000022000000022200000002222222222222222222222200000000222
2222222222222222222220000000000222222222222220222200000002200000002222222222222222222222200000000222
2222222222222222222220000000000022222222220020222220000002000000002222222222222222222222200000000002
2222222222222222222222000022220000222222200022222200000022000000002222222222222222222222000000000002
0222222222222222222222202222220000222222200002222200000222000000022222222222222222222200000000000002
0022222222222222222222222222200000022222222000222200000222202220002222222222222222200000000000000222
0022222222222222222222222222000000002222222000220000000222222220002222222222222222000000000000002222
0222222222222222222222222222200000002222222002200000000002222222002222222222222222000000000000222222
2222222222222222222222222002200000002222222222220000000202222200000222222222222222220000000000222222
2222222222222222202222222222000000022222222222200002222222222222222222222222222222220000000000222022
